000010001000100001000000000000
000001110000011000000000000000
000000000001001000000000000000
000001000010000000000100000000
000000110001001000101000000000
000000000001000000010000000000
100100000010000010100000000000
000000001000000110100000000000
100000000000000010000000000001
000000001000000010001010000000
000000110000000010000000000000
000000000100000000100100000000
000000000001010000001000000011
100001000000000000000000000010
000000010000100000010011000000
000000000000000000000100000001
100000000000000000000000001001
001000001000000100000000000000
000000000001010010000000000001
100000000000000000000000100000
100000000010100000000000000001
000010100000000000000000001000
000000000000100000000000000110
000000100000100001000001000000
100000000100000000001000000001
110000010000010000000000010000
000001000100000100000100000100
000000000000001000100000000000
000010010001000000000000000000
000010000100000100000000100000