111112000111111120111111222200001112111012111112
000022200011100000000200000011114211111111111112
111111101110101010222111111111111111112222111110
222222222222222222222111111111111111112222111112
000000000000000000000111111111111111112222111111
111111101110101010222111111111111111112222111112
222222222222222222222111111111111111112222111112
