000022200011100000000200000011110211111111111112000111111120111111222200001112111012111111120111111222200001112111012
111111101110101010222111111111111111112222111112000111111120111111222200001112111012111111120111111222200001112111012
222222222222222222222111111111111111112222111112000111111120111111222200001112111012111111120111111222200001112111012
000000000000000000000111111111111111112222111112000111111120111111222200001112111012111111120111111222200001112111012
111111101110101010222111111111111111112222111112000111111120111111222200001112111012111111120111111222200001112111012
222222222222222222222111111111111111112222111112000111111120111111222200001112111012111111120111111222200001112111012
111112000111111120111111222200001112111012111112000111111120111111222200001112111012111111120111111222200001112111012
000022200011100000000200000011110211111111111112000111111120111111222200001112111012111111120111111222200001112111012
111111101110101010222111111111111111112222111112000111111120111111222200001112111012111111120111111222200001112111012
222222222222222222222111111111111111112222111112000111111120111111222200001112111012111111120111111222200001112111012
000000000000000000000111111111111111112222111112000111111120111111222200001112111012111111120111111222200001112111012
111111101110101010222111111111111111112222111112000111111120111111222200001112111012111111120111111222200001112111012
222222222222222222222111111111111111112222111112000111111120111111222200001112111012111111120111111222200001112111012
000022200011100000000200000011110211111111111112000111111120111111222200001112111012111111120111111222200001112111012
111111101110101010222111111111111111112222111112000111111120111111222200001112111012111111120111111222200001112111012
222222222222222222222111111111111111112222111112000111111120111111222200001112111012111111120111111222200001112111012
000000000000000000000111111111111111112222111112000111111120111111222200001112111012111111120111111222200001112111012
111111101110101010222111111111111111112222111112000111111120111111222200001112111012111111120111111222200001112111012
222222222222222222222111111111111111112222111112000111111120111111222200001112111012111111120111111222200001112111012
000022200011100000000200000011110211111111111112000111111120111111222200001112111012111111120111111222200001112111012
111111101110101010222111111111111111112222111112000111111120111111222200001112111012111111120111111222200001112111012
222222222222222222222111111111111111112222111112000111111120111111222200001112111012111111120111111222200001112111012
222222222222222222222111111111111111112222111112000111111120111111222200001112111012111111120111111222200001112111012