00002220001110000000020000001111021111111111111111021111111111111111021111111111111
11111110111010101022211111111111111111222211111111021111111111111111021111111111111
22222222222222222222211111111111111111222211111111021111111111111111021111111111111
00000000000000000000011111111111111111222211111111021111111111111111021111111111111
11111110111010101022211111111111111111222211111111021111111111111111021111111111111
22222222222222222222211111111111111111222211111111021111111111111111021111111111111
11111200011111112011111122220000111211101211111111021111111111111111021111111111111
00002220001110000000020000001111021111111111111111021111111111111111021111111111111
11111110111010101022211111111111111111222211111111021111111111111111021111111111111
22222222222222222222211111111111111111222211111111021111111111111111021111111111111
00000000000000000000011111111111111111222211111111021111111111111111021111111111111
11111110111010101022211111111111111111222211111111021111111111111111021111111111111
22222222222222222222211111111111111111222211111111021111111111111111021111111111111
00002220001110000000020000001111021111111111111111021111111111111111021111111111111
11111110111010101022211111111111111111222211111111021111111111111111021111111111111
00002220001110000000020000001111021111111111111111021111111111111111021111111111111
11111110111010101022211111111111111111222211111111021111111111111111021111111111111
22222222222222222222211111111111111111222211111111021111111111111111021111111111111
00000000000000000000011111111111111111222211111111021111111111111111021111111111111
11111110111010101022211111111111111111222211111111021111111111111111021111111111111
22222222222222222222211111111111111111222211111111021111111111111111021111111111111
00002220001110000000020000001111021111111111111111021111111111111111021111111111111
11111110111010101022211111111111111111222211111111021111111111111111021111111111111