111112000111111120111111222200001112111012
000022200011100000000200000011114211111111
111111101110101010222111111111111111112222
222222222222222222222111111111111111112222
000000000000000000000111111111111111112222
111111101110101010222111111111111111112222
222222222222222222222111111111111111112222