222222222222222222222222222222
222222222222222222222222222222
222222222222222222222222222222
222222222222222222222222222222
222222222222222222222222222222
222221111111111111111111122222
222221111110111111111111122222
222221111111111110101111122222
222221110011111111110110122222
222221111111110111111111122222
222221111111111111111101122222
222221111110111111111110122222
222221111111111011101111122222
222221011111111111111111122222
222221011111111111111111122222
222221111111111111110111122222
222221111111111110111111122222
222221011011111111111111122222
222221011111111010111101122222
222221110111111111111010122222
222221111111111111110111022222
222221111111111110111111122222
222221011111111101011100122222
222221111111111111111111122222
222221111111111111111111122222
222222222222222222222222222222
222222222222222222222222222222
222222222222222222222222222222
222222222222222222222222222222
222222222222222222222222222222