000010001000100001000000000000
000001110000011000000000000000
000000010001101000000000000000
000001000010000000000100000000
000000111001001000101000000000
000000000001010000010000000000
100100000010000010100100000000
000000001000100110100000000000
100000100000000010000000000001
000000001000000010001010000000
000000110000011010000000000000
000000000100000000100100000000
000000000001110000001000000011
100001010000000000000000000010
000000010001100000010011000000
000000000000000000000100000011
100000000000000000000000001111
001000001000000100000000000001
000000000001110010000000000001
100001000000000000000000100001
100000000011100000000000000001
001011100000000000000000001000
000000000000100000000000000111
000000100000100001000001000000
100000000100000010001000000001
110000010000010000000000010000
000001000101000100000100000100
000000000011001000100000000000
000010010001000000000000000000
010010000100000100000000100000