11112221111111111111121111111111121111111111111111121111111111111111121111111111111
11111111111111111122211111111111111111222211111111121111111111111111121111111111111
22222222222222222222211111111111111111222211111111121111111111111111121111111111111
11111111111111111111111111111111111111222211111111121111111111111111121111111111111
11111111111111111122211111111111111111222211111111121111111111111111121111111111111
22222222222222222222211111111111111111222211111111121111111111111111121111111111111
11111211111111112111111122221111111211111211111111121111111111111111121111111111111
11112221111111111111121111111111121111111111111111121111111111111111121111111111111
11111111111111111122211111111111111111222211111111121111111111111111121111111111111
22222222222222222222211111111111111111222211111111121111111111111111121111111111111
11111111111111111111111111111111111111222211111111121111111111111111121111111111111
11111111111111111122211111111111111111222211111111121111111111111111121111111111111
22222222222222222222211111111111111111222211111111121111111111111111121111111111111
11112221111111111111121111111111121111111111111111121111111111111111121111111111111
11111111111111111122211111111111111111222211111111121111111111111111121111111111111
11112221111111111111121111111111121111111111111111121111111111111111121111111111111
11111111111111111122211111111111111111222211111111121111111111111111121111111111111
22222222222222222222211111111111111111222211111111121111111111111111121111111111111
11111111111111111111111111111111111111222211111111121111111111111111121111111111111
11111111111111111122211111111111111111222211111111121111111111111111121111111111111
22222222222222222222211111111111111111222211111111121111111111111111121111111111111
11112221111111111111121111111111121111111111111111121111111111111111121111111111111
11111111111111111122211111111111111111222211111111121111111111111111121111111111111