000010001000100001000000000100
000001110010001100000000001000
001000010001101000000000000100
000001000010000000000100000001
100000111001001000101000000100
100000000001010000010000000000
100100000010001010100100000000
000001001000100110100100000000
100001100000000010000000000001
000001001000010010001010000000
100000110000011010000000000000
100000000100000000100100000001
000100000001110000101000000011
100001010000000000000000100010
000000010101100000010011010000
000000000001000000000100000011
100000000010000000001000001111
001001001000000100000000000001
000000001001110010000000000001
100001000000000000010000100001
100000001011100000010000000001
001011100000010000000100001000
000000000000100000000100000111
000000101100100101000001000000
100010000100000010001000000001
110000010000010001000000010000
000001000101000100100100000100
000101000011001000100000000000
000010010001001000000010000001
010010000100000100000100100001