101010001000100001000000000101
001001110010001100010000001000
001000011101101001010000000100
000001010010000100100100000001
100000111001001000101000100101
100000001001010100010000100001
100100001010011010100100001000
000101001000100110100100001000
101001100001000010000000100001
000001001000010010001010100000
100000110000011010001100010000
100010000100000010100110000001
100100000001111000101001000011
101001010000100000001000100010
010000010101100000110011010100
010010010001000001000100000011
100001000011000000001000001111
011001001000010100010000000001
000000001001110010000100011001
100001000001001000010000110001
100010001011101000010000000001
001011100101010010100100001000
000000000011100100010100000111
000000101101110101000001000000
100010000100010010001000000101
110000011000010001001000010000
000001000101010100101100000100
000101000011001000100001000000
000010010001001000100010000001
010010000101000100000100100001