0000222000111000000002000000111102111111111111120001111111201111112222000011121110121111111201111112
1111111011101010102221111111111111111122221111120001111111201111112222000011121110121111111201111112
2222222222222222222221111111111111111122221111120001111111201111112222000011121110121111111201111112
0000000000000000000001111111111111111122221111120001111111201111112222000011121110121111111201111112
1111111011101010102221111111111111111122221111120001111111201111112222000011121110121111111201111112
2222222222222222222221111111111111111122221111120001111111201111112222000011121110121111111201111112
1111120001111111201111112222000011121110121111120001111111201111112222000011121110121111111201111112
0000222000111000000002000000111102111111111111120001111111201111112222000011121110121111111201111112
1111111011101010102221111111111111111122221111120001111111201111112222000011121110121111111201111112
2222222222222222222221111111111111111122221111120001111111201111112222000011121110121111111201111112
0000000000000000000001111111111111111122221111120001111111201111112222000011121110121111111201111112
1111111011101010102221111111111111111122221111120001111111201111112222000011121110121111111201111112
2222222222222222222221111111111111111122221111120001111111201111112222000011121110121111111201111112
0000222000111000000002000000111102111111111111120001111111201111112222000011121110121111111201111112
1111111011101010102221111111111111111122221111120001111111201111112222000011121110121111111201111112
1111111011101010102221111111111111111122221111120001111111201111112222000011121110121111111201111112
0000000000000000000001111111111111111122221111120001111111201111112222000011121110121111111201111112
1111111011101010102221111111111111111122221111120001111111201111112222000011121110121111111201111112
2222222222222222222221111111111111111122221111120001111111201111112222000011121110121111111201111112
0000222000111000000002000000111142111111111111120001111111201111112222000011121110121111111201111112
1111111011101010102221111111111111111122221111120001111111201111112222000011121110121111111201111112
2222222222222222222221111111111111111122221111120001111111201111112222000011121110121111111201111112
2222222222222222222221111111111111111122221111120001111111201111112222000011121110121111111201111112