101010001000100001000001000101
001001110010001100010101001000
001100011101101001010000000100
000101010010000100101100000001
100000111001001000101110100101
100000001001010100010100100001
100100101010011010100100001000
000101001110100110100100001000
101001100001010010000000100001
100001001000010110001010100000
101010110000011010001100010000
100010010100110010100110000001
100100000001111000101001000011
101001010000100100001000100010
010000010101110100110011010100
110110010001000001000100000011
100001001011000000001000001111
011001001000010101011000000001
000000001001110010000101011001
100101000001001001010000110001
100110001011101000010000000001
001011101101010010100100001000
010010000011100100010100000111
000100101101110101000001000000
100010000100010010001000000101
110000011010010001001000010000
000011000101010100101100000100
000101000111001000100001000101
000010010001001000100010000101
010010000101000101000100101001