222222222222222222222222222222
201001111010011100010101001002
201101011111101001010001010102
201101010010000100101100100002
200110111001001100101110100102
200001101001010100010100100002
200100101010011110100101010002
210111001110101110100100001002
201001110010101110010000100002
200001001100010110011010100002
201011110010011010001100010002
200010011110110010100110000002
200100000001111010101001100012
201001010000100110001000110012
210000010101110101110011011102
211110010001000011000100000012
200101101011000100001000001112
211001001000011111011000000002
210000001001111010000101011002
201101010001001001010000110002
200110011011101000110000000002
201011111101010010100100101002
210010000011100100011100100112
200100111101110101001001000002
200010010101010010001000000102
210000011011010001001000010002
200011000101110101101100000102
200101000111001011100001000102
200010011001001001100010000102
222222222222222222222222222222