222222222222222222222222222222
222222222222222222222222222222
221101011111111001010001010122
221101010010000100101100100022
221110111011001100101110100122
220001101011010100010100100022
220100101010111110100101010022
220111011110101110100100001022
221001110010101110010000100022
220001011100010110011010100022
221111110010011010001100010022
220010111110110010101110000022
220100111001111010101001100022
221001010010100110001100110022
220011010101110101110011011122
221110110101000011000100000022
220101101111000100001000101122
221001001000011111011000100122
220001001001111010100101011022
221101110101001001010000110022
220110011011101010110001000022
221011111101110010100100101022
220011000011101100011100100122
220101111101111101001001000022
220010110101010010001001000122
220000011011010001001001010022
220011000101110101101101000122
220101000111011011100001000122
222222222222222222222222222222
222222222222222222222222222222