222222222222222222222222222222
222222222222222222222222222222
222222222222222222222222222222
222101010010101100101100100222
222110111011101100101110100222
222001101011010100110100100222
222100111010111110101101010222
222111011111101110101100001222
222001110010101111010100100222
222001011100010110011011100222
222111110010011010101101010222
222011111110110010101110000222
222101111011111010101001100222
222001010011100110011100110222
222011010101110111110011011222
222110110101000011010111000222
222101111111010100001000101222
222001011000011111011000100222
222001001111111010100101011222
222101110101001011110000110222
222110011011101010110101000222
222011111111110010100100101222
222011011011101100011100100222
222101111111111101001001000222
222010110101010110001001000222
222001011011010001011001010222
222011000101110101111101000222
222222222222222222222222222222
222222222222222222222222222222
222222222222222222222222222222