222222222222222222222222222222
222222222222222222222222222222
222222222222222222222222222222
222222222222222222222222222222
222210111011111100111110102222
222201101011010110111100102222
222200111110111110111101012222
222211011111111110101101002222
222201110010101111110110102222
222201111101010110011011102222
222211110110011010101101012222
222211111110110110101110002222
222201111011111011101001102222
222201011011100110011100112222
222211010111110111110111012222
222210110111100011010111002222
222201111111010100101010102222
222201011010011111011100102222
222201011111111010101101012222
222201110101001011110010112222
222210111111101110110101002222
222211111111110110100100102222
222211011011111101011100102222
222201111111111101001011002222
222210110101010110101101002222
222201011011010101011001012222
222222222222222222222222222222
222222222222222222222222222222
222222222222222222222222222222
222222222222222222222222222222